1  1  1  1  1  1  1  1  1  1  1  1  1  1  1  1  1  1  1  1  1  1  1  1  1  1  1  1  1  1  1  1  1  1  1  1  1  1  1  1  1  1  1  1  1  1  1  1  1  1  1  1
1  1  1  1  1  1  1  1  1  1  1  1  1  1  1  1  1  1  1  1  1  1  1  1  1  1  1  1  1  1  1  1  1  1  1  1  1  1  1  1  1  1  1  1  1  1  1  1  1  1  1  1
1  1  1  1  1  1  1  1  1  1  1  1  1  1  1  1  1  1  1  1  1  1  1  1  1  1  1  1  1  1  1  1  1  1  1  1  1  1  1  1  1  1  1  1  1  1  1  1  1  1  1  1
1  1  1  1  1  1  1  1  1  1  1  1  1  1  1  1  1  1  1  1  1  1  1  1  1  1  1  1  1  1  1  1  1  1  1  1  1  1  1  1  1  1  1  1  1  1  1  1  1  1  1  1
1  1  1  1  1  1  1  1  1  1  1  1  1  1  1  1  1  1  1  1  1  1  1  1  1  1  1  1  1  1  1  1  1  1  1  1  1  1  1  1  1  1  1  1  1  1  1  1  1  1  1  1
1  1  1  1  1  1  1  1  1  1  1  1  1  1  1  1  1  1  1  1  1  1  1  1  1  1  1  1  1  1  1  1  1  1  1  1  1  1  1  1  1  1  1  1  1  1  1  1  1  1  1  1
1  1  1  1  1  1  1  1  1  1  1  1  1  14  10  10  2  4  4  4  4  2  10  10  10  10  15  1  14  10  15  1  14  10  15  1  14  10  15  1  1  1  1  1  1  1  1  1  1  1  1  1  
1  1  1  1  1  1  1  1  1  1  1  1  14  18  0  0  2  4  4  4  4  2  0  5  0  0  0  7  0  0  0  7  0  0  0  7  0  0  19  15  1  1  1  1  1  1  1  1  1  1  1  1  1
1  1  1  1  1  1  1  1  1  1  1  14  18  0  0  0  2  4  4  4  4  2  0  5  0  0  0  7  0  7  0  7  0  7  0  7  0  7  0  19  15  1  1  1  1  1  1  1  1  1  1  1  
1  1  1  1  1  1  1  1  1  1  14  18  0  0  0  0  2  4  4  4  4  2  0  5  0  0  0  7  0  7  0  7  0  7  0  7  0  7  0  7  19  15  1  1  1  1  1  1  1  1  1  1
1  1  1  1  1  1  1  1  1  14  18  2  0  0  0  0  2  2  2  4  2  2  0  5  0  0  0  7  0  7  0  7  0  7  0  7  0  7  0  7  7  19  15  1  1  1  1  1  1  1  1  1
1  1  1  1  1  1  1  1  14  18  0  0  0  0  0  0  0  0  0  0  0  0  0  5  0  0  0  7  0  7  0  7  0  7  0  7  0  7  0  7  7  0  19  15  1  1  1  1  1  1  1  1
1  1  1  1  1  1  1  1  11  0  0  0  0  0  0  0  0  0  0  0  0  0  0  5  0  0  0  7  0  7  0  7  0  7  0  7  0  7  0  7  7  0  3  12  1  1  1  1  1  1  1  1
1  1  1  1  1  1  1  1  11  0  0  0  2  2  0  2  0  0  2  0  0  0  0  5  0  0  0  7  0  7  0  0  0  7  0  0  0  7  0  0  0  0  0  17  1  1  1  1  1  1  1  1
1  1  1  1  1  1  1  1  11  0  0  0  2  0  0  0  2  0  0  0  0  0  2  5  0  0  0  7  0  7  7  7  7  7  7  7  7  7  7  7  7  7  7  1  1  1  1  1  1  1  1  1
1  1  1  1  1  1  1  1  11  0  0  2  0  0  0  0  0  0  2  0  2  0  0  5  0  0  0  7  0  4  4  4  4  4  4  4  4  4  4  4  4  4  4  15  1  1  1  1  1  1  1  1
1  1  1  1  1  1  1  1  11  0  2  2  2  2  2  2  0  0  0  2  0  0  0  5  0  0  0  7  7  7  7  7  7  7  7  7  7  7  7  7  7  7  4  12  1  1  1  1  1  1  1  1
1  1  1  1  1  1  1  1  11  0  2  4  4  4  4  2  0  0  0  0  2  0  2  5  0  0  0  7  4  4  4  4  4  4  4  4  4  4  4  4  4  4  4  17  1  1  1  1  1  1  1  1
1  1  1  1  1  1  1  1  11  0  2  4  4  4  4  2  0  2  0  0  0  0  0  5  0  0  0  7  4  7  7  7  7  7  7  7  7  7  7  7  7  7  7  1  1  1  1  1  1  1  1  1
1  1  1  1  1  1  1  1  11  0  2  4  4  4  4  2  0  0  0  0  0  0  0  5  0  0  0  7  4  4  4  4  4  4  4  4  4  4  4  4  4  4  4  15  1  1  1  1  1  1  1  1
1  1  1  1  1  1  1  1  11  0  2  2  4  2  2  2  0  0  0  2  0  0  2  5  0  0  0  7  7  7  7  7  7  7  7  7  7  7  7  7  7  7  4  12  1  1  1  1  1  1  1  1
1  1  1  1  1  1  1  1  11  0  0  5  4  4  0  0  0  2  0  0  0  0  0  5  0  0  0  7  4  4  4  4  4  4  4  4  4  4  4  4  4  4  4  17  1  1  1  1  1  1  1  1
1  1  1  1  1  1  1  1  11  0  5  5  4  4  0  0  0  0  0  0  0  2  0  5  0  0  0  7  4  7  7  7  7  7  7  7  7  7  7  7  7  7  7  1  1  1  1  1  1  1  1  1
1  1  1  1  1  1  1  1  11  0  5  5  4  4  0  0  2  0  0  0  2  0  0  5  0  0  0  7  4  4  4  4  4  4  4  4  4  4  4  4  4  4  4  15  1  1  1  1  1  1  1  1
1  1  1  1  1  1  1  1  11  5  5  5  4  4  0  0  0  0  0  0  0  0  0  5  0  0  0  7  7  7  7  7  7  7  7  7  7  7  7  7  7  7  4  12  1  1  1  1  1  1  1  1
1  1  1  1  1  1  1  1  11  0  0  5  4  4  4  4  4  4  4  4  4  4  4  4  4  4  4  4  4  4  4  4  4  4  4  4  4  4  4  4  4  4  4  12  1  1  1  1  1  1  1  1
1  1  1  1  1  1  1  1  11  5  5  5  4  4  4  4  4  4  4  4  4  4  4  4  4  4  4  4  4  4  4  4  4  4  4  4  4  4  4  4  4  4  4  12  1  1  1  1  1  1  1  1
1  1  1  1  1  1  1  1  11  0  0  5  5  5  5  5  5  5  5  5  5  5  5  6  6  0  6  6  0  7  7  7  7  7  7  7  7  7  7  7  7  7  0  12  1  1  1  1  1  1  1  1
1  1  1  1  1  1  1  1  11  5  5  0  0  0  0  0  0  0  0  0  0  6  6  6  0  0  0  6  6  6  7  7  7  7  7  7  7  7  7  7  7  7  0  12  1  1  1  1  1  1  1  1
1  1  1  1  1  1  1  1  11  0  0  0  0  0  0  0  0  0  6  6  6  6  0  0  0  0  0  0  0  6  6  6  6  0  0  0  0  0  0  0  0  0  0  12  1  1  1  1  1  1  1  1
1  1  1  1  1  1  1  1  16  0  0  0  0  0  6  6  6  6  6  0  0  0  0  6  6  6  6  6  0  0  6  0  6  6  6  6  6  0  0  0  0  0  0  17  1  1  1  1  1  1  1  1
1  1  1  1  1  1  1  1  1  6  6  6  6  6  6  6  0  0  0  0  6  6  0  6  6  6  6  6  0  0  6  0  6  0  6  0  6  6  6  6  6  6  6  1  1  1  1  1  1  1  1  1  1  1
1  1  1  1  1  1  1  1  14  0  0  0  0  0  3  6  0  6  6  6  6  6  0  6  6  6  6  6  6  0  6  0  0  0  6  0  6  0  6  0  6  0  0  15  1  1  1  1  1  1  1  1
1  1  1  1  1  1  1  1  11  6  6  6  6  6  6  6  0  6  6  0  0  0  0  6  6  6  6  6  0  0  0  0  6  0  6  0  6  0  6  0  6  0  0  12  1  1  1  1  1  1  1  1
1  1  1  1  1  1  1  1  11  6  0  0  0  0  0  0  0  6  6  0  6  6  0  6  6  6  6  6  6  6  6  6  6  0  6  0  6  0  6  0  6  0  0  12  1  1  1  1  1  1  1  1
1  1  1  1  1  1  1  1  11  6  0  6  6  6  6  6  0  6  6  0  6  6  0  6  6  6  6  6  0  0  0  0  0  0  6  0  0  0  6  0  6  0  0  12  1  1  1  1  1  1  1  1
1  1  1  1  1  1  1  1  11  6  0  6  6  6  6  6  0  6  6  0  6  6  0  6  6  6  6  6  6  0  6  6  6  6  6  0  6  0  6  0  6  0  0  12  1  1  1  1  1  1  1  1
1  1  1  1  1  1  1  1  11  6  6  6  6  6  6  6  0  6  6  0  6  6  0  6  6  6  6  6  0  0  0  0  0  0  0  0  6  0  6  0  6  0  3  12  1  1  1  1  1  1  1  1
1  1  1  1  1  1  1  1  16  20  0  0  6  6  6  6  0  6  6  0  6  6  0  6  6  6  6  6  6  6  6  6  6  6  6  6  6  0  6  0  6  0  21  17  1  1  1  1  1  1  1  1
1  1  1  1  1  1  1  1  1  16  20  6  3  0  6  6  0  6  6  6  6  6  0  6  6  6  6  6  0  0  0  0  0  0  0  0  0  0  6  0  6  21  17  1  1  1  1  1  1  1  1  1
1  1  1  1  1  1  1  1  1  1  16  20  6  0  0  0  0  6  6  0  6  6  0  6  6  6  6  6  0  6  6  6  6  6  6  6  6  6  6  0  21  17  1  1  1  1  1  1  1  1  1  1
1  1  1  1  1  1  1  1  1  1  1  16  20  0  6  6  6  6  6  0  6  6  0  6  6  6  6  6  0  0  0  0  0  0  0  0  0  0  0  21  17  1  1  1  1  1  1  1  1  1  1  1
1  1  1  1  1  1  1  1  1  1  1  1  16  20  6  6  6  6  6  0  6  0  0  6  6  6  6  6  6  6  6  6  6  6  6  6  6  6  21  17  1  1  1  1  1  1  1  1  1  1  1  1
1  1  1  1  1  1  1  1  1  1  1  1  1  16  13  13  13  13  13  17  1  16  17  1  1  1  1  1  16  13  13  13  13  13  13  13  13  13  17  1  1  1  1  1  1  1  1  1  1  1  1  1
1  1  1  1  1  1  1  1  1  1  1  1  1  1  1  1  1  1  1  1  1  1  1  1  1  1  1  1  1  1  1  1  1  1  1  1  1  1  1  1  1  1  1  1  1  1  1  1  1  1  1  1
1  1  1  1  1  1  1  1  1  1  1  1  1  1  1  1  1  1  1  1  1  1  1  1  1  1  1  1  1  1  1  1  1  1  1  1  1  1  1  1  1  1  1  1  1  1  1  1  1  1  1  1
1  1  1  1  1  1  1  1  1  1  1  1  1  1  1  1  1  1  1  1  1  1  1  1  1  1  1  1  1  1  1  1  1  1  1  1  1  1  1  1  1  1  1  1  1  1  1  1  1  1  1  1
1  1  1  1  1  1  1  1  1  1  1  1  1  1  1  1  1  1  1  1  1  1  1  1  1  1  1  1  1  1  1  1  1  1  1  1  1  1  1  1  1  1  1  1  1  1  1  1  1  1  1  1
1  1  1  1  1  1  1  1  1  1  1  1  1  1  1  1  1  1  1  1  1  1  1  1  1  1  1  1  1  1  1  1  1  1  1  1  1  1  1  1  1  1  1  1  1  1  1  1  1  1  1  1
1  1  1  1  1  1  1  1  1  1  1  1  1  1  1  1  1  1  1  1  1  1  1  1  1  1  1  1  1  1  1  1  1  1  1  1  1  1  1  1  1  1  1  1  1  1  1  1  1  1  1  1
